6x6
w|w|w|w|w|w
w|f|w|r|s|w
w|r|w|w|r|w
w|r|r|r|r|w
w|w|r|w|r|w
w|w|w|w|w|w