6x6
w|w|w|w|w|w
w|r|r|w|f|w
w|w|r|w|r|w
w|r|s|r|r|w
w|r|w|r|w|w
w|w|w|w|w|w