7x7
w|w|w|w|w|w|w
w|r|r|r|w|r|w
w|f|w|r|r|r|w
w|w|w|s|w|w|w
w|r|r|r|w|r|w
w|r|w|r|r|r|w
w|w|w|w|w|w|w