7x7
w|w|w|w|w|w|w
w|r|r|r|r|f|w
w|w|r|w|w|w|w
w|r|r|r|r|r|w
w|r|w|r|w|r|w
w|s|r|r|r|w|w
w|w|w|w|w|w|w