7x7
w|w|w|w|w|w|w
w|r|r|r|r|r|w
w|r|w|w|w|r|w
w|r|w|s|r|r|w
w|w|w|w|r|w|w|
w|f|r|r|r|r|w
w|w|w|w|w|w|w